60 15
  6  6  6  6  6  6  6  6  6  6  6  6  6  6  6  6  6  6  6  6  6  6  6  6  6  6  6  6  6  6  6  6  6  6  6  6  6  6  6  6  6  6  6  6  6  6  6  6  6  6  6  6  6  6  6  6  6  6  6  6
  6 -1 -1 -1 -1 -1 -1 -1 -1 -1 -1 -1 -1 -1 -1 -1 -1 -1 -1 -1 -1 -1  6 -1 -1 -1 -1 -1 -1 -1 -1 -1 -1 -1 -1 -1 -1 -1 -1 -1 -1 -1 -1 -1 -1 -1 -1 -1 -1 -1 -1 -1 -1 -1 -1 -1 -1 -1  7  6
  6 -1 -1 -1 -1 -1 -1 -1 -1 -1 -1 -1 -1 -1 -1 -1 -1 -1 -1 -1 -1 -1  6 -1 -1 -1 -1 -1 -1 -1 -1 -1 -1 -1 -1 -1 -1 -1 -1 -1 -1 -1 -1 -1 -1 -1 -1 -1 -1 -1 -1 -1 -1 -1 -1 -1 -1 -1  7  6
  6 -1 -1 -1 -1 -1 -1 -1 -1 -1 -1 -1 -1 -1 -1 -1 -1 10 10 -1 -1 -1  6 -1 -1 -1 10 10 10 -1 -1 -1 -1 -1 -1 -1 -1 -1 -1 -1 -1 -1 -1 -1 -1 -1 -1 -1 -1 -1 -1 -1 -1 -1 -1 -1 -1 -1  6  6
  6 -1 -1 -1 -1 -1 -1 -1 -1 -1 -1 -1 -1 -1 -1 -1 -1  1  4 -1 -1 10  9 10 -1 -1  1  2  4 -1 -1 -1 -1 -1 10 10 -1 -1 -1 10 -1 -1 -1 -1 -1 -1 -1 -1 -1 10 10 -1 -1 -1 -1 -1 -1 -1 14  6
  6 -1 -1 -1 -1 -1 -1 -1 -1 -1 -1 -1 -1 -1 10 10 12  6  6 12 -1 10  6 10 -1 12  6  6  6 -1 -1 -1 -1 -1 -1 -1 -1 -1 10 -1 10 -1 -1 12 12 -1 -1 -1 10 10 10 10 10 -1 -1 -1 -1 -1 15  6
  6 -1 -1 -1 -1 -1 -1 10 10 10 10 -1 -1  1  2  2  2  6  6 -1 -1 10  6 10 -1 -1  6  6  6 10 -1 -1 -1 -1 -1 -1 -1 -1 -1 -1 -1 10 -1 12 12 -1 -1 -1  1  2  2  2  2  2  2  2  2  2  2  8
  6 -1 -1 -1 -1 -1 10 -1 -1 -1 -1 -1 12  6  6  9  6  7  6 -1 -1  0  6  5 -1 -1  6  7  6  4 -1 10 10 -1  0  2  5 10 -1 -1 -1 10 10 12 12 -1 -1 -1  6  6  6  6  6  9  6  8  6  6  6  6
  6 -1 -1 -1 -1 10 -1 -1 10 10 10  1  2  6  6  6  6  6  6 -1 -1 -1 -1 -1 -1 -1  6  6  6  6 -1 -1 -1 -1 -1 -1 -1 -1 -1 10 -1 -1 -1 -1 -1 -1 -1  1  6  6  8  6  6  6  6  6  6  7  6  6
  6 -1 -1 -1 10 -1 -1 -1  1  2  2  6  7  6  6  6  8  6  6 10 10 10 10 10 10 10  6  6  6  6 -1 -1 -1 -1 -1 -1 -1 -1 -1 -1 -1 -1 -1 -1 -1 -1 -1  7  6  6  6  6  6  6  6  6  6  6  6  6
  6  2  2  2  4  3  3  1  6  6  8  6  6  6  9  6  6  6  6  2  2  2  2  2  2  2  6  9  6  6  4  3  3  1  2  2  2  2  2  4  3  3  1  2  2  2  2  6  8  6  6  6  6  6  6  6  6  6  6  6
  6  6  7  6  6  9  6  6  6  6  6  6  6  6  6  6  6  6  6  6  6  6  8  6  6  6  6  6  6  6  6  7  6  6  6  6  6  8  6  6  7  6  6  9  6  6  6  6  6  6  6  6  6  6  6  6  6  6  6  6
  6  6  6  6  6  6  6  8  6  6  6  6  6  6  6  6  6  7  6  6  6  6  6  6  6  6  8  6  6  6  6  6  6  6  6  6  6  6  6  6  6  6  6  6  6  6  6  6  6  6  6  6  6  6  6  6  6  6  6  6
  6  6  6  6  6  6  6  6  6  6  6  6  6  6  6  6  6  6  6  6  6  6  6  6  6  6  6  6  6  6  6  6  6  6  6  6  6  6  6  6  6  6  6  6  6  6  6  6  6  6  6  6  6  6  6  6  6  6  6  6
  6  6  6  6  6  6  6  6  6  6  6  6  6  6  6  6  6  6  6  6  6  6  6  6  6  6  6  6  6  6  6  6  6  6  6  6  6  6  6  6  6  6  6  6  6  6  6  6  6  6  6  6  6  6  6  6  6  6  6  6