13 11
 2 0 0 0 0 0 0 0 2 0 0 0 0
 0 2 0 0 0 0 0 2 0 2 0 0 0
 0 0 2 0 0 0 2 0 0 0 2 0 0
 0 0 0 2 0 2 0 0 0 0 0 2 0
 0 0 0 0 2 0 0 0 0 0 0 0 2
 0 0 0 0 0 0 0 0 0 0 0 0 0
 1 2 3 0 1 3 0 1 3 0 1 2 3
 0 4 0 0 4 0 0 4 0 0 0 4 0
 0 4 0 0 4 3 0 4 3 0 0 4 0
 0 4 0 0 4 0 0 0 4 0 0 4 0
 0 5 0 0 5 5 0 5 5 0 0 5 0