30 10
  6 -1 -1 -1 -1 -1 -1 -1 -1 -1 -1 -1 -1 -1 -1 -1 -1 -1 -1 -1 -1 -1 -1 -1 -1 -1 -1 -1 -1  6
  6 -1 -1 -1 -1 11 10 -1 -1 -1 10 -1 -1 -1 -1 -1 -1 -1 -1 -1 -1 -1 -1 -1 -1 -1 -1 -1 -1  6
  6 -1 -1 -1 -1 -1 -1 -1 -1 10 -1 10 -1 -1 -1 -1 -1 -1 -1 11 10 10 10 11 -1 -1 -1 -1 -1  6
  8 -1 -1 -1 -1 -1 -1 -1 -1 -1 -1 -1 11 -1 -1 -1 -1 -1 -1  1  2  2  2  2  2  2  2  2  2  6
  6 -1 10 10 -1  0  2  5 -1 -1 -1 -1 10 10 10 10 -1 -1 -1  6  6  6  6  6  6  6  6  6  6  6
  6 -1 -1 -1 -1 -1 -1 -1 -1 -1 10 -1 -1 -1 -1 -1 -1 -1  1  6  6  8  6  6  6  6  6  6  6  6
  6 -1 -1 -1 -1 -1 -1 -1 -1 -1 -1 -1 -1 -1 -1 -1 -1 -1  7  6  6  6  6  6  6  6  6  6  6  6
  6  2  2  2  2  2  2  2  2  4  3  3  1  2  2  2  2  2  6  8  6  6  6  6  6  6  6  6  6  6
  6  6  7  6  6  6  6  6  8  6  6  7  6  6  9  6  6  6  6  6  6  6  6  6  6  6  6  6  6  6
  6  6  6  6  6  6  6  6  6  6  6  6  6  6  6  6  6  6  6  6  6  6  6  6  6  6  6  6  6  6