XXXXXXXXXXXXXXXXXXXXXXXX
XP2          1        PX
X XXXXTXXXXX XXXXXXXXX2X
X X           1      X X
X XXXXXXX XXXXXXX XXXX X
X      XX XXXXX3X    X X
X XXXX XX1      XXXX2X X
X XXXX XX XXXXX2X    X X
X P       XXXXXXX XXXX X
X Xf tXXX        1     X
X Xf t    XXXXXFX XXXX X
X Xf t XX XXXXX3X X    X
X1Xf t XXB      X X2XX1X
X Xf t XX XXXXXXX XXXX X
X Xf t XX        1     X
X Xf t XX XXfXX XGXXXX X
X         X         3X X
X XX XX X X XXX XXXX3X X
X XX XX X X2XXX XXXXTX X
X    X1 X X XXX   1    X
X XX X XX X     XXXXXX X
X2XX X XX XXtXX XXXXXX X
XP          1        2PX
XXXXXXXXXXXXXXXXXXXXXXXX