XXXXXXXXXXXXXXXXXXXXXXXX
XP2          1        PX
X XXXXXXXXXX XXXXXXXXX2X
X X           1      X X
X XXXXXXX XXXXXXX XXXX X
X      XX XXXXX3X    X X
X XXXX XX1      XXXX2X X
X XXXX XX XXXXX2X    X X
X         XXXXXXX XXXX X
X XX XXXX        1     X
X XX XP   XXXXXXX XXXX X
X XX X XX XXXXX3X X    X
X1XX X XX1    PPX X2XX1X
X XX X XX XXXXXXX XXXX X
X XX X XX      B 1     X
X XX X XX XXXXX XXXXXX X
X         X         3X X
X XX XX X X XXX XXXX3X X
X XX XX X X2XXX XXXXXX X
X    X1 X X XXX   1    X
X XX X XX X     XXXXXX X
X2XX X XX XXXXX XXXXXX X
XP          1        2PX
XXXXXXXXXXXXXXXXXXXXXXXX