XXXXXXXXXXXXXXXXXXXXXXXX
XP2          1        PX
X XXXXXXXXXX XXXXXXXXX2X
X X           1      X X
X XXXXXXX XXXXXXX XXXX X
X      XX XXXXX3X    X X
X XXXX XX1      XXXX2X X
X XXXX XX XXXXX2X    X X
X         XXXXXXX XXXX X
X Xf tXXX        1     X
X Xf tP   XXXXXFX XXXX X
X Xf t XX XXXXX3X X    X
X1Xf t XX1    PPX X2XX1X
X Xf t XX XXXXXXX XXXX X
X Xf t XX      B 1     X
X Xf t XX XXXXX XGXXXX X
X         X         3X X
X XX XX X X XXX XXXX3X X
X XX XX X X2XXX XXXXTX X
X    X1 X X XXX   1    X
X XX X XX X     XXXXXX X
X2XX X XX XXXXX XXXXXX X
XP          1        2PX
XXXXXXXXXXXXXXXXXXXXXXXX